############
#        O #
#   P  #####
#          #
### ### #  #
#  O ## #  #
#    ##    #
#          #
#       XX #                  
#       #  #
############