###############
#           O##
#O       P ####
#        X#####
#### # #      #
   # # #    X #
   #          #
   ###########N